|--------------|
|..............|
|.....--...|...|
|......|...|...|
|......|...|...|
|......----|...|
|....--........|
|..........----|
|...|---.......|
|---|..........|
|..............|
|.....---......|
|---..|-|......|
|.....|-|---...|
|...--|-|......|
|--------------|
