                              ------------------
                              |................|
|------------------------------................--------------------------------|
|..............................................................................|
|..............................................................................|
|..............................................................................|
|..............................................................................|
|..............................................................................|
|.................................----.........................................|
|.................................|  |.........................................|
|.................................----.........................................|
|...........----...............................................................|
|...........|  |...............................................................|
|...........----...............................................................|
|..............................................................................|
|..........................................................----................|
|..........................................................|  |................|
|..........................................................----................|
|..............................................................................|
|..............................................................................|
|..............................................................................|
|..............................................................................|
|..............................................................................|
|----------------------------------.............-------------------------------|
                                  |.............|
                                  |.............|
                                  ---------------