    ..................
    |................|
    |.........................|
    |.........................|
    |.........................|
    |.........................|
    |.........................|
                 |............|
                 |............|
                 ..............