...........|                                                                                                                                                                                                                  |...........
...........|                                                                                                                                                                                                                  |...........
...........|                                                                                                                                                                                                                  |...........
...........|                                                                                                                                                                                                                  |...........
...........|                                                                                                                                                                                                                  |...........
...........|                                                                                                     -------------                                                                                                |...........
...........|                                                                                       --------      -                         -------------                                                                      |...........
...........|                                                                       ----------                    -                                     -                                                                      |...........
...........|                                                   --------------                                    -                                     -                                                                      |...........
...........|------------------------------------------------------------------------------------------------------------------------------------------------------------------------------------------------------------------|...........
...........|..................................................................................................................................................................................................................|...........
...........|..................................................................................................................................................................................................................|...........
...........|..................................................................................................................................................................................................................|...........
...........|..................................................................................................................................................................................................................|...........
...........|..................................................................................................................................................................................................................|...........
...........|..................................................................................................................................................................................................................|...........