|------------------------------------------|
|..........................................|
|..........................................|
|..........................................|
|..........................................|
|..........................................|
|..........................................|
|......-----------.........................|
|...............................-----------|
|..........................................|
|..........................................|
|.................------...................|
|..........................................|
|------------------------------------------|
