|------------------------------------------|
|..........................................|
|..........................................|
|..........................................|
|..........................................|
|..........................................|
|..........................................|
|......-----------.........................|
|..............................------------|
|..........................................|
|..........................................|
|.................------...................|
|..........................................|
|------------------------------------------|
