         ------------------
         |................|
    |-----................-----|
    |..........................|
    |..........................|
    |..........................|
    |..........................|
    |...........----...........|
    |...........|  |...........|
    |...........----...........|
    |..........................|
    |..........................|
    |..........................|
    |..........................|
    |------.............-------|
          |.............|
          |.............|
          ---------------