|------------------------------------------|
|                                          |
|                                          |
|                                          |
|                                          |
|                                          |
|                                          |
|      -----------                         |
|                              ------------|
|                                          |
|                                          |
|                 ------    ----           |
|                                          |
|------------------------------------------|
