|-------------------|
|...................|
|.....--...|........|
|......|...|........|
|......|...|........|
|......----|........|
|....--.............|
|..........----....-|
|...|---............|
|---|...............|
|...................|
|.....---...........|
|---..|-|...........|
|.....|-|-------....|
|...................|
|........-----------|
|...................|
|.......|...........|
|.......|-----------|
|.......|-----......|
|...................|
|-------------------|