|-------------------------|
|.........................|
|.....--...|..............|
|......|...|..............|
|......|...|..............|
|......----|..............|
|....--...................|
|..........----....-------|
|...|---............|.....|
|---|...............|.....|
|.........................|
|...........---...........|
|---........|-|...........|
|...........|-|-------....|
|.........................|
|----..........-----------|
|.........................|
|..........|..............|
|..........|--------......|
|.......|--|..............|
|.........................|
|-------------------------|